Name	ReportingUnitType
Montana;US House MT District 1	congressional
Montana;Beaverhead County	county
Montana;Big Horn County	county
Montana;Blaine County	county
Montana;Broadwater County	county
Montana;Carbon County	county
Montana;Carter County	county
Montana;Cascade County	county
Montana;Chouteau County	county
Montana;Custer County	county
Montana;Daniels County	county
Montana;Dawson County	county
Montana;Deer Lodge County	county
Montana;Fallon County	county
Montana;Fergus County	county
Montana;Flathead County	county
Montana;Gallatin County	county
Montana;Garfield County	county
Montana;Glacier County	county
Montana;Golden Valley County	county
Montana;Granite County	county
Montana;Hill County	county
Montana;Jefferson County	county
Montana;Judith Basin County	county
Montana;Lake County	county
Montana;Lewis & Clark County	county
Montana;Lewis and Clark County	county
Montana;Liberty County	county
Montana;Lincoln County	county
Montana;Madison County	county
Montana;McCone County	county
Montana;Meagher County	county
Montana;Mineral County	county
Montana;Missoula County	county
Montana;Musselshell County	county
Montana;Park County	county
Montana;Petroleum County	county
Montana;Phillips County	county
Montana;Pondera County	county
Montana;Powder River County	county
Montana;Powell County	county
Montana;Prairie County	county
Montana;Ravalli County	county
Montana;Richland County	county
Montana;Roosevelt County	county
Montana;Rosebud County	county
Montana;Sanders County	county
Montana;Sheridan County	county
Montana;Silver Bow County	county
Montana;Stillwater County	county
Montana;Sweet Grass County	county
Montana;Teton County	county
Montana;Toole County	county
Montana;Treasure County	county
Montana;Valley County	county
Montana;Wheatland County	county
Montana;Wibaux County	county
Montana;Yellowstone County	county
Montana	state
Montana;MT House District 1	state-house
Montana;MT House District 10	state-house
Montana;MT House District 100	state-house
Montana;MT House District 11	state-house
Montana;MT House District 12	state-house
Montana;MT House District 13	state-house
Montana;MT House District 14	state-house
Montana;MT House District 15	state-house
Montana;MT House District 16	state-house
Montana;MT House District 17	state-house
Montana;MT House District 18	state-house
Montana;MT House District 19	state-house
Montana;MT House District 2	state-house
Montana;MT House District 20	state-house
Montana;MT House District 21	state-house
Montana;MT House District 22	state-house
Montana;MT House District 23	state-house
Montana;MT House District 24	state-house
Montana;MT House District 25	state-house
Montana;MT House District 26	state-house
Montana;MT House District 27	state-house
Montana;MT House District 28	state-house
Montana;MT House District 29	state-house
Montana;MT House District 3	state-house
Montana;MT House District 30	state-house
Montana;MT House District 31	state-house
Montana;MT House District 32	state-house
Montana;MT House District 33	state-house
Montana;MT House District 34	state-house
Montana;MT House District 35	state-house
Montana;MT House District 36	state-house
Montana;MT House District 37	state-house
Montana;MT House District 38	state-house
Montana;MT House District 39	state-house
Montana;MT House District 4	state-house
Montana;MT House District 40	state-house
Montana;MT House District 41	state-house
Montana;MT House District 42	state-house
Montana;MT House District 43	state-house
Montana;MT House District 44	state-house
Montana;MT House District 45	state-house
Montana;MT House District 46	state-house
Montana;MT House District 47	state-house
Montana;MT House District 48	state-house
Montana;MT House District 49	state-house
Montana;MT House District 5	state-house
Montana;MT House District 50	state-house
Montana;MT House District 51	state-house
Montana;MT House District 52	state-house
Montana;MT House District 53	state-house
Montana;MT House District 54	state-house
Montana;MT House District 55	state-house
Montana;MT House District 56	state-house
Montana;MT House District 57	state-house
Montana;MT House District 58	state-house
Montana;MT House District 59	state-house
Montana;MT House District 6	state-house
Montana;MT House District 60	state-house
Montana;MT House District 61	state-house
Montana;MT House District 62	state-house
Montana;MT House District 63	state-house
Montana;MT House District 64	state-house
Montana;MT House District 65	state-house
Montana;MT House District 66	state-house
Montana;MT House District 67	state-house
Montana;MT House District 68	state-house
Montana;MT House District 69	state-house
Montana;MT House District 7	state-house
Montana;MT House District 70	state-house
Montana;MT House District 71	state-house
Montana;MT House District 72	state-house
Montana;MT House District 73	state-house
Montana;MT House District 74	state-house
Montana;MT House District 75	state-house
Montana;MT House District 76	state-house
Montana;MT House District 77	state-house
Montana;MT House District 78	state-house
Montana;MT House District 79	state-house
Montana;MT House District 8	state-house
Montana;MT House District 80	state-house
Montana;MT House District 81	state-house
Montana;MT House District 82	state-house
Montana;MT House District 83	state-house
Montana;MT House District 84	state-house
Montana;MT House District 85	state-house
Montana;MT House District 86	state-house
Montana;MT House District 87	state-house
Montana;MT House District 88	state-house
Montana;MT House District 89	state-house
Montana;MT House District 9	state-house
Montana;MT House District 90	state-house
Montana;MT House District 91	state-house
Montana;MT House District 92	state-house
Montana;MT House District 93	state-house
Montana;MT House District 94	state-house
Montana;MT House District 95	state-house
Montana;MT House District 96	state-house
Montana;MT House District 97	state-house
Montana;MT House District 98	state-house
Montana;MT House District 99	state-house
Montana;MT Senate District 1	state-senate
Montana;MT Senate District 10	state-senate
Montana;MT Senate District 11	state-senate
Montana;MT Senate District 12	state-senate
Montana;MT Senate District 13	state-senate
Montana;MT Senate District 14	state-senate
Montana;MT Senate District 15	state-senate
Montana;MT Senate District 16	state-senate
Montana;MT Senate District 17	state-senate
Montana;MT Senate District 18	state-senate
Montana;MT Senate District 19	state-senate
Montana;MT Senate District 2	state-senate
Montana;MT Senate District 20	state-senate
Montana;MT Senate District 21	state-senate
Montana;MT Senate District 22	state-senate
Montana;MT Senate District 23	state-senate
Montana;MT Senate District 24	state-senate
Montana;MT Senate District 25	state-senate
Montana;MT Senate District 26	state-senate
Montana;MT Senate District 27	state-senate
Montana;MT Senate District 28	state-senate
Montana;MT Senate District 29	state-senate
Montana;MT Senate District 3	state-senate
Montana;MT Senate District 30	state-senate
Montana;MT Senate District 31	state-senate
Montana;MT Senate District 32	state-senate
Montana;MT Senate District 33	state-senate
Montana;MT Senate District 34	state-senate
Montana;MT Senate District 35	state-senate
Montana;MT Senate District 36	state-senate
Montana;MT Senate District 37	state-senate
Montana;MT Senate District 38	state-senate
Montana;MT Senate District 39	state-senate
Montana;MT Senate District 4	state-senate
Montana;MT Senate District 40	state-senate
Montana;MT Senate District 41	state-senate
Montana;MT Senate District 42	state-senate
Montana;MT Senate District 43	state-senate
Montana;MT Senate District 44	state-senate
Montana;MT Senate District 45	state-senate
Montana;MT Senate District 46	state-senate
Montana;MT Senate District 47	state-senate
Montana;MT Senate District 48	state-senate
Montana;MT Senate District 49	state-senate
Montana;MT Senate District 5	state-senate
Montana;MT Senate District 50	state-senate
Montana;MT Senate District 6	state-senate
Montana;MT Senate District 7	state-senate
Montana;MT Senate District 8	state-senate
Montana;MT Senate District 9	state-senate
