Name	ReportingUnitType
North Dakota;ND House District 1	state-house
North Dakota;ND House District 2	state-house
North Dakota;ND House District 3	state-house
North Dakota;ND House District 4	state-house
North Dakota;ND House District 5	state-house
North Dakota;ND House District 6	state-house
North Dakota;ND House District 7	state-house
North Dakota;ND House District 8	state-house
North Dakota;ND House District 9	state-house
North Dakota;ND House District 10	state-house
North Dakota;ND House District 11	state-house
North Dakota;ND House District 12	state-house
North Dakota;ND House District 13	state-house
North Dakota;ND House District 14	state-house
North Dakota;ND House District 15	state-house
North Dakota;ND House District 16	state-house
North Dakota;ND House District 17	state-house
North Dakota;ND House District 18	state-house
North Dakota;ND House District 19	state-house
North Dakota;ND House District 20	state-house
North Dakota;ND House District 21	state-house
North Dakota;ND House District 22	state-house
North Dakota;ND House District 23	state-house
North Dakota;ND House District 24	state-house
North Dakota;ND House District 25	state-house
North Dakota;ND House District 26	state-house
North Dakota;ND House District 27	state-house
North Dakota;ND House District 28	state-house
North Dakota;ND House District 29	state-house
North Dakota;ND House District 30	state-house
North Dakota;ND House District 31	state-house
North Dakota;ND House District 32	state-house
North Dakota;ND House District 33	state-house
North Dakota;ND House District 34	state-house
North Dakota;ND House District 35	state-house
North Dakota;ND House District 36	state-house
North Dakota;ND House District 37	state-house
North Dakota;ND House District 38	state-house
North Dakota;ND House District 39	state-house
North Dakota;ND House District 40	state-house
North Dakota;ND House District 41	state-house
North Dakota;ND House District 42	state-house
North Dakota;ND House District 43	state-house
North Dakota;ND House District 44	state-house
North Dakota;ND House District 45	state-house
North Dakota;ND House District 46	state-house
North Dakota;ND House District 47	state-house
North Dakota;ND House District 48	state-house
North Dakota;ND House District 49	state-house
North Dakota;ND House District 50	state-house
North Dakota;ND House District 51	state-house
North Dakota;ND House District 52	state-house
North Dakota;ND House District 53	state-house
North Dakota;ND House District 54	state-house
North Dakota;ND House District 55	state-house
North Dakota;ND House District 56	state-house
North Dakota;ND House District 57	state-house
North Dakota;ND House District 58	state-house
North Dakota;ND House District 59	state-house
North Dakota;ND House District 60	state-house
North Dakota;ND House District 61	state-house
North Dakota;ND House District 62	state-house
North Dakota;ND House District 63	state-house
North Dakota;ND House District 64	state-house
North Dakota;ND House District 65	state-house
North Dakota;ND House District 66	state-house
North Dakota;ND House District 67	state-house
North Dakota;ND House District 68	state-house
North Dakota;ND House District 69	state-house
North Dakota;ND House District 70	state-house
North Dakota;ND House District 71	state-house
North Dakota;ND House District 72	state-house
North Dakota;ND House District 73	state-house
North Dakota;ND House District 74	state-house
North Dakota;ND House District 75	state-house
North Dakota;ND House District 76	state-house
North Dakota;ND House District 77	state-house
North Dakota;ND House District 78	state-house
North Dakota;ND House District 79	state-house
North Dakota;ND House District 80	state-house
North Dakota;ND House District 81	state-house
North Dakota;ND House District 82	state-house
North Dakota;ND House District 83	state-house
North Dakota;ND House District 84	state-house
North Dakota;ND House District 85	state-house
North Dakota;ND House District 86	state-house
North Dakota;ND House District 87	state-house
North Dakota;ND House District 88	state-house
North Dakota;ND House District 89	state-house
North Dakota;ND House District 90	state-house
North Dakota;ND House District 91	state-house
North Dakota;ND House District 92	state-house
North Dakota;ND House District 93	state-house
North Dakota;ND House District 94	state-house
North Dakota;ND Senate District 1	state-senate
North Dakota;ND Senate District 2	state-senate
North Dakota;ND Senate District 3	state-senate
North Dakota;ND Senate District 4	state-senate
North Dakota;ND Senate District 5	state-senate
North Dakota;ND Senate District 6	state-senate
North Dakota;ND Senate District 7	state-senate
North Dakota;ND Senate District 8	state-senate
North Dakota;ND Senate District 9	state-senate
North Dakota;ND Senate District 10	state-senate
North Dakota;ND Senate District 11	state-senate
North Dakota;ND Senate District 12	state-senate
North Dakota;ND Senate District 13	state-senate
North Dakota;ND Senate District 14	state-senate
North Dakota;ND Senate District 15	state-senate
North Dakota;ND Senate District 16	state-senate
North Dakota;ND Senate District 17	state-senate
North Dakota;ND Senate District 18	state-senate
North Dakota;ND Senate District 19	state-senate
North Dakota;ND Senate District 20	state-senate
North Dakota;ND Senate District 21	state-senate
North Dakota;ND Senate District 22	state-senate
North Dakota;ND Senate District 23	state-senate
North Dakota;ND Senate District 24	state-senate
North Dakota;ND Senate District 25	state-senate
North Dakota;ND Senate District 26	state-senate
North Dakota;ND Senate District 27	state-senate
North Dakota;ND Senate District 28	state-senate
North Dakota;ND Senate District 29	state-senate
North Dakota;ND Senate District 30	state-senate
North Dakota;ND Senate District 31	state-senate
North Dakota;ND Senate District 32	state-senate
North Dakota;ND Senate District 33	state-senate
North Dakota;ND Senate District 34	state-senate
North Dakota;ND Senate District 35	state-senate
North Dakota;ND Senate District 36	state-senate
North Dakota;ND Senate District 37	state-senate
North Dakota;ND Senate District 38	state-senate
North Dakota;ND Senate District 39	state-senate
North Dakota;ND Senate District 40	state-senate
North Dakota;ND Senate District 41	state-senate
North Dakota;ND Senate District 42	state-senate
North Dakota;ND Senate District 43	state-senate
North Dakota;ND Senate District 44	state-senate
North Dakota;ND Senate District 45	state-senate
North Dakota;ND Senate District 46	state-senate
North Dakota;ND Senate District 47	state-senate
North Dakota;US House ND District 1	congressional
North Dakota	state
North Dakota;Adams County	county
North Dakota;Barnes County	county
North Dakota;Benson County	county
North Dakota;Billings County	county
North Dakota;Bottineau County	county
North Dakota;Bowman County	county
North Dakota;Burke County	county
North Dakota;Burleigh County	county
North Dakota;Cass County	county
North Dakota;Cavalier County	county
North Dakota;Dickey County	county
North Dakota;Divide County	county
North Dakota;Dunn County	county
North Dakota;Eddy County	county
North Dakota;Emmons County	county
North Dakota;Foster County	county
North Dakota;Golden Valley County	county
North Dakota;Grand Forks County	county
North Dakota;Grant County	county
North Dakota;Griggs County	county
North Dakota;Hettinger County	county
North Dakota;Kidder County	county
North Dakota;LaMoure County	county
North Dakota;Logan County	county
North Dakota;McHenry County	county
North Dakota;McIntosh County	county
North Dakota;McKenzie County	county
North Dakota;McLean County	county
North Dakota;Mercer County	county
North Dakota;Morton County	county
North Dakota;Mountrail County	county
North Dakota;Nelson County	county
North Dakota;Oliver County	county
North Dakota;Pembina County	county
North Dakota;Pierce County	county
North Dakota;Ramsey County	county
North Dakota;Ransom County	county
North Dakota;Renville County	county
North Dakota;Richland County	county
North Dakota;Rolette County	county
North Dakota;Sargent County	county
North Dakota;Sheridan County	county
North Dakota;Sioux County	county
North Dakota;Slope County	county
North Dakota;Stark County	county
North Dakota;Steele County	county
North Dakota;Stutsman County	county
North Dakota;Towner County	county
North Dakota;Traill County	county
North Dakota;Walsh County	county
North Dakota;Ward County	county
North Dakota;Wells County	county
North Dakota;Williams County	county
