Name	ReportingUnitType
California;US House CA District 1	congressional
California;US House CA District 10	congressional
California;US House CA District 11	congressional
California;US House CA District 12	congressional
California;US House CA District 13	congressional
California;US House CA District 14	congressional
California;US House CA District 15	congressional
California;US House CA District 16	congressional
California;US House CA District 17	congressional
California;US House CA District 18	congressional
California;US House CA District 19	congressional
California;US House CA District 2	congressional
California;US House CA District 20	congressional
California;US House CA District 21	congressional
California;US House CA District 22	congressional
California;US House CA District 23	congressional
California;US House CA District 24	congressional
California;US House CA District 25	congressional
California;US House CA District 26	congressional
California;US House CA District 27	congressional
California;US House CA District 28	congressional
California;US House CA District 29	congressional
California;US House CA District 3	congressional
California;US House CA District 30	congressional
California;US House CA District 31	congressional
California;US House CA District 32	congressional
California;US House CA District 33	congressional
California;US House CA District 34	congressional
California;US House CA District 35	congressional
California;US House CA District 36	congressional
California;US House CA District 37	congressional
California;US House CA District 38	congressional
California;US House CA District 39	congressional
California;US House CA District 4	congressional
California;US House CA District 40	congressional
California;US House CA District 41	congressional
California;US House CA District 42	congressional
California;US House CA District 43	congressional
California;US House CA District 44	congressional
California;US House CA District 45	congressional
California;US House CA District 46	congressional
California;US House CA District 47	congressional
California;US House CA District 48	congressional
California;US House CA District 49	congressional
California;US House CA District 5	congressional
California;US House CA District 50	congressional
California;US House CA District 51	congressional
California;US House CA District 52	congressional
California;US House CA District 53	congressional
California;US House CA District 6	congressional
California;US House CA District 7	congressional
California;US House CA District 8	congressional
California;US House CA District 9	congressional
California;Alameda County	county
California;Alpine County	county
California;Amador County	county
California;Butte County	county
California;Calaveras County	county
California;Colusa County	county
California;Contra Costa County	county
California;Del Norte County	county
California;El Dorado County	county
California;Fresno County	county
California;Glenn County	county
California;Humboldt County	county
California;Imperial County	county
California;Inyo County	county
California;Kern County	county
California;Kings County	county
California;Lake County	county
California;Lassen County	county
California;Los Angeles County	county
California;Madera County	county
California;Marin County	county
California;Mariposa County	county
California;Mendocino County	county
California;Merced County	county
California;Modoc County	county
California;Mono County	county
California;Monterey County	county
California;Napa County	county
California;Nevada County	county
California;Orange County	county
California;Placer County	county
California;Plumas County	county
California;Riverside County	county
California;Sacramento County	county
California;San Benito County	county
California;San Bernardino County	county
California;San Diego County	county
California;San Francisco County	county
California;San Joaquin County	county
California;San Luis Obispo County	county
California;San Mateo County	county
California;Santa Barbara County	county
California;Santa Clara County	county
California;Santa Cruz County	county
California;Shasta County	county
California;Sierra County	county
California;Siskiyou County	county
California;Solano County	county
California;Sonoma County	county
California;Stanislaus County	county
California;Sutter County	county
California;Tehama County	county
California;Trinity County	county
California;Tulare County	county
California;Tuolumne County	county
California;Ventura County	county
California;Yolo County	county
California;Yuba County	county
California	state
California;CA House District 1	state-house
California;CA House District 10	state-house
California;CA House District 11	state-house
California;CA House District 12	state-house
California;CA House District 13	state-house
California;CA House District 14	state-house
California;CA House District 15	state-house
California;CA House District 16	state-house
California;CA House District 17	state-house
California;CA House District 18	state-house
California;CA House District 19	state-house
California;CA House District 2	state-house
California;CA House District 20	state-house
California;CA House District 21	state-house
California;CA House District 22	state-house
California;CA House District 23	state-house
California;CA House District 24	state-house
California;CA House District 25	state-house
California;CA House District 26	state-house
California;CA House District 27	state-house
California;CA House District 28	state-house
California;CA House District 29	state-house
California;CA House District 3	state-house
California;CA House District 30	state-house
California;CA House District 31	state-house
California;CA House District 32	state-house
California;CA House District 33	state-house
California;CA House District 34	state-house
California;CA House District 35	state-house
California;CA House District 36	state-house
California;CA House District 37	state-house
California;CA House District 38	state-house
California;CA House District 39	state-house
California;CA House District 4	state-house
California;CA House District 40	state-house
California;CA House District 41	state-house
California;CA House District 42	state-house
California;CA House District 43	state-house
California;CA House District 44	state-house
California;CA House District 45	state-house
California;CA House District 46	state-house
California;CA House District 47	state-house
California;CA House District 48	state-house
California;CA House District 49	state-house
California;CA House District 5	state-house
California;CA House District 50	state-house
California;CA House District 51	state-house
California;CA House District 52	state-house
California;CA House District 53	state-house
California;CA House District 54	state-house
California;CA House District 55	state-house
California;CA House District 56	state-house
California;CA House District 57	state-house
California;CA House District 58	state-house
California;CA House District 59	state-house
California;CA House District 6	state-house
California;CA House District 60	state-house
California;CA House District 61	state-house
California;CA House District 62	state-house
California;CA House District 63	state-house
California;CA House District 64	state-house
California;CA House District 65	state-house
California;CA House District 66	state-house
California;CA House District 67	state-house
California;CA House District 68	state-house
California;CA House District 69	state-house
California;CA House District 7	state-house
California;CA House District 70	state-house
California;CA House District 71	state-house
California;CA House District 72	state-house
California;CA House District 73	state-house
California;CA House District 74	state-house
California;CA House District 75	state-house
California;CA House District 76	state-house
California;CA House District 77	state-house
California;CA House District 78	state-house
California;CA House District 79	state-house
California;CA House District 8	state-house
California;CA House District 80	state-house
California;CA House District 9	state-house
California;CA Senate District 1	state-senate
California;CA Senate District 10	state-senate
California;CA Senate District 11	state-senate
California;CA Senate District 12	state-senate
California;CA Senate District 13	state-senate
California;CA Senate District 14	state-senate
California;CA Senate District 15	state-senate
California;CA Senate District 16	state-senate
California;CA Senate District 17	state-senate
California;CA Senate District 18	state-senate
California;CA Senate District 19	state-senate
California;CA Senate District 2	state-senate
California;CA Senate District 20	state-senate
California;CA Senate District 21	state-senate
California;CA Senate District 22	state-senate
California;CA Senate District 23	state-senate
California;CA Senate District 24	state-senate
California;CA Senate District 25	state-senate
California;CA Senate District 26	state-senate
California;CA Senate District 27	state-senate
California;CA Senate District 28	state-senate
California;CA Senate District 29	state-senate
California;CA Senate District 3	state-senate
California;CA Senate District 30	state-senate
California;CA Senate District 31	state-senate
California;CA Senate District 32	state-senate
California;CA Senate District 33	state-senate
California;CA Senate District 34	state-senate
California;CA Senate District 35	state-senate
California;CA Senate District 36	state-senate
California;CA Senate District 37	state-senate
California;CA Senate District 38	state-senate
California;CA Senate District 39	state-senate
California;CA Senate District 4	state-senate
California;CA Senate District 40	state-senate
California;CA Senate District 5	state-senate
California;CA Senate District 6	state-senate
California;CA Senate District 7	state-senate
California;CA Senate District 8	state-senate
California;CA Senate District 9	state-senate
California;CA Board of Equalization Member District 2	board-of-equalization-district
California;CA Board of Equalization Member District 1	board-of-equalization-district
California;CA Board of Equalization Member District 4	board-of-equalization-district
California;CA Board of Equalization Member District 3	board-of-equalization-district

